建筑	n	
火灾	n
建筑火灾	nz
火灾危害	nz	
危害	n		
安全	an	
规范	n	
新建建筑	nz
改建建筑	nz
扩建建筑	nz	
厂房	n	
仓库	n	
甲类	n	
乙类	n	
丙类	n	
液体储罐区	nz
液体储罐	nz			
可燃气体储罐区	nz
可燃气体储罐	nz
助燃气体储罐区	nz
助燃气体储罐	nz
可燃材料堆场	nz	
城市交通	n	
隧道	n
城市交通隧道	nz	
人民防空工程	nz	
工程	n	
石油和天然气工程	n		
石油化工工程	n	
火力发电厂	n	
变电站	n	
专门	n	
国家标准	n		
规定	n	
火药	n	
炸药	n		
花炮厂	nt		
功能	n	
场所	n		
国家	n		
方针政策	n			
高度	n			
措施	n	
消防	n	
消防主管部门	nz
高层建筑	nz			
住宅建筑	nz
住宅	nz	
单层	n
非单层	nz
民用建筑	nz	
裙房	n	
主体	n	
投影	n	
范围	n
建筑主体投影范围	nz
建筑主体	nz
附属建筑	nz	
公共建筑	n
重要公共建筑	nz	
人员伤亡	n
重大人员伤亡	nz	
财产损失	n	
严重社会影响	nz	
商业	n		
网点	n
商业服务网点	nz
首层	nz
二层	nz
分隔单位	nz		
建筑面积	n	
商店	n	
邮政所	n	
储蓄所	n	
理发店	n	
营业性用房	nz		
高架仓库	nz	
货架	n	
机械化操作	nz
自动化控制	nz	
地下室	n
半地下室	nz	
房间	n	
地面	n
房间地面	nz
室外设计地面	nz	
室外	s	
设计地面	nz
平均高度	nz	
净高	n	
明火地点	nz	
室内外	s	
火焰	n
外露火焰	nz
赤热表面	nz	
表面	n		
灶具	n	
电磁炉	n	
散发火花地点	nz	
飞火	n	
烟囱	n	
砂轮	n	
电焊	n	
气焊	n	
气割	n	
作业	n	
试验	vn		
耐火极限	nz
标准耐火试验	nz	
构件	n
建筑构件	nz	
配件	n
建筑配件	nz	
结构	n
建筑结构	nz		
完整性	n	
隔热性	n		
隔墙	n
防火隔墙	nz	
区域	n
相邻区域	nz	
不燃性	n	
墙体	n
不燃性墙体	nz	
防火墙	n
相邻水平防火分区	nz
防火分区	nz	
避难层	nz
避难间	nz		
烟气	n	
楼层	n
安全出口	nz
安全疏散	nz
疏散	nz		
楼梯间	n	
室外楼梯	n
出入口	nz
出口	nz
入口	nz
直通室外安全区域	nz
封闭楼梯间	nz
防烟楼梯间	nz
防烟前室	nz		
门	n	
烟	n	
热气	n	
前室	n	
阳台	n
开敞式阳台	nz	
凹廊	n	
设施	n	
通向前室	nz
通向楼梯间	nz
防火门	nz
避难走道	nz
走道	n		
闪点	n	
可燃性	n
可燃性液体	nz
液体	nz
固体	nz		
蒸气	n
气体	n
粉尘	n	
空气	n	
混合物	n	
火源	n	
最低温度	n	
闭杯法测定	nz
爆炸下限	nz	
粉尘	n	
发生爆炸	n	
浓度	n
最低浓度	nz
沸溢性油品	nz		
油品	n		
热波	n	
防火间距	nz
着火建筑	nz
相邻建筑	nz
间隔距离	nz	
间隔	n	
距离	n
建筑内部	nz
楼板	nz
防火分隔设施	nz
局部空间	nz
空间	n			
充实水柱	nz	
水枪喷嘴	nz	
射流	n	
水量	n	
直径	n	
圆孔	n		
长度	ns	
泄压面积	n
泄压比	n
储罐	n
管道	n
公称直径	n	
建筑高差	nz
封闭段	n	
封闭段长度	nz	
人数	n	
座位数	n	
特征	n	
爆炸特征指数	nz	
建筑物	n	
体积	n
堆场	nz	
瓶组	n	
容积	n	
容量	n
粮食筒仓	nz
席穴囤	nz
土园仓	nz
储量	nz		
危险性	n		
物质性质	nz	
物质数量	nz	
丁类	n	
戊类	n		
易燃物	nz	
可燃物	nz		
本层	n	
比例	n	
油漆工段	nz
防火措施	nz	
火灾事故	n		
封闭喷漆工艺	nz
封闭喷漆空间	nz		
负压	n	
可燃气体	nz
可燃气体探测报警系统	nz		
自动抑爆系统	nz	
储存物品	nz
火灾危险性物品	nz
火灾危险性	nz 		
重量	n
可燃包装重量	nz
可燃包装体积	nz
耐火等级	nz
一级	nz
二级	nz
三级	nz
四级	nz
燃烧性能	nz
不燃材料	nz	
吊顶	n	
高层厂房	nz		
单层厂房	nz	
多层厂房	nz
火花	nz
明火	nz		
机器	n	
仪表	n	
仪器	n	
设备	vn	
锅炉房	n	
燃煤锅炉房	nz	
锅炉	n		
蒸发量	n	
油浸变压器室	nz			
高压配电装置室	nz		
变电站	nz
高层仓库	nz	
钢板仓	nz
粮食平房仓	nz
散装粮食平房仓	nz
防火保护	nz
金属承重构件	nz
自动喷水灭火系统	nz
屋顶承重构件	nz
非承重外墙	nz
难燃性墙体	nz
房间隔墙	nz
预应力钢筋混凝土	nz
上人平屋顶	nz
屋面板	nz
屋面防水层	nz
可燃防水材料	nz
可燃保温材料	nz
难燃保温材料	nz
防水材料	n
防护层	nz
金属夹芯板材	nz
芯材	nz
防水层	n		
保温材料	n				
木柱	nz	
预制钢筋混凝土构件	nz
节点外露部位	nz
防火保护措施	nz
节点	n	
层数	n
最大容许建筑面积	nz	
防火卷帘	nz
防火分隔水幕	nz
麻纺厂房	nz
纺织厂房	nz
原棉开包	nz
清花车间	nz
甲级防火门	nz
甲级防火窗	nz
造纸生产联合厂房	nz
湿式造纸联合厂房	nz
纸机烘缸罩	nz
有效灭火设施保护	nz
工段	nz
谷物筒仓工作塔	nz
卷烟生产联合厂房	nz	
原料	n	
备料	n	
成组配方	nz		
制丝包	n	
储丝包	n	
卷接包	nz	
二氧化碳膨胀烟丝	nz	
生产用房	nz
防火分隔单元	nz
车间	nz	
水平防火分隔	nz
竖向防火分隔	nz
操作平台	nz
检修平台	nz
平台	n
面积	n
窗	nz
洞口	nz
地下仓库	nz
半地下仓库	nz
最大允许占地面积	nz
地上仓库	nz
石油库区	nz
石油库	nz
桶装油品仓库	nz
煤均化库	nz
硝酸铵仓库	nz
电石仓库	nz
聚乙烯高分子制品仓库	nz
尿素仓库	nz
配煤仓库	nz
造纸厂仓库	nz
棉花库房	nz
冷库	nz
员工宿舍	nz			
办公室	n	
休息室	nz	
防爆墙	nz
乙级防火门	nz
中间仓库	nz
外墙	nz
不燃性楼板	nz
丙类液体中间储罐	nz
中间储罐	nz	
配电站	n
爆炸性气体	nz
爆炸性粉尘	nz
粉尘	nz
变电站	nz
无门洞口	nz
无窗洞口	nz
电力装置	nz
甲级防火窗	nz
物流建筑	nz	
建筑功能	n	
丙类高架仓库	nz	
棉	n	
麻	nr	
毛	nr	
纺织品	n	
泡沫塑料	nz		
水	n
火灾自动报警系统	nz	
铁路线	n	
蒸汽机车	n	
内燃机车	n
屋顶	nz
可燃性屋檐	nz
天窗	n
可燃蒸汽	nz
铁路	n	
道路	n	
铁路装卸线	nz	
安全措施	nz
液化石油气储罐	nz	
石油气	n	
煤	n	
焦炭	n	
化学易燃物品	nz	
外壁	n
室外设备	nz
丙类液体储罐	nz
甲类厂房	nz
占地面积	nz
一级汽车加油站	nz
一级汽车加气站	nz
一级汽车加油加气合建站	nz
汽车加油站	nz
汽车加气站	nz
汽车加油加气合建站	nz
汽车加油站	nz
汽车加气站	nz
汽车加油加气合建站	nz
加油机	nz
加气机	nz
储油罐	nz
储气罐	nz
汽车加油加气站	nz
电力系统	nz
电压	nz
室外变电站	nz
室外配电站	nz
工业企业	nz
变压器	nz
室外变压变电站	nz
围墙	n
厂区围墙	n
粮食立筒仓	nz
粮食浅园仓	nz
工作塔	nz
接收塔	nz
发放站	nz
承重结构	nz
钢筋混凝土框架结构	nz
钢筋混凝土排架结构	nz
钢框架结构	nz
钢排架结构	nz
泄压设施	nz
轻质屋面板	nz
轻质墙体	nz	
安全玻璃	nz	
人员密集场所	nz
主要交通道路	nz
防冰雪积聚措施	nz
公共截面	nz
截面	nz
横截面周长	nz
横截面积	nz
粉尘爆炸指数	nz
顶棚	nz
厂房上部空间	nz	
绝缘材料	n
整体面层	n
防静电措施	nz
可燃粉尘	nz
可燃纤维	nz	
地沟	n	
盖板	n
防火材料	nz
梁	nz
柱	nz
主要承重构件	nz
总控制室	nz
分控制室	nz
门斗	nz	
沟	n	
管	n
下水道	n
隔油设施	nz
防止液体流散的设施	nz	
通廊	n
粮食储存设施	nz
防爆措施	nz
最近边缘	nz
直线距离	nz	
疏散楼梯	n
走道	nz
疏散走道	nz
门	nz
疏散门	nz
最小疏散净宽度	nz
最小净宽度	nz
疏散人数	nz
总净宽度	nz
宽度	nz
下层楼梯	nz
首层	nz
首层外门	nz
外门	nz
封闭楼梯间	nz	
金库	nz
粮食钢板筒仓	nz
室外金属梯	nz
筒仓室外楼梯平台	nz
提升设施	nz	
井壁	nz	
井筒	n
城市边缘	nz
区域边缘	nz
全年最小频率风向	nz
上风侧	nz
液化石油气	nz
地势平坦	nz
地势开阔	nz
露天存放	nz
桶装甲类液体	nz
瓶装甲类液体	nz
液化石油气储罐组	nz
液化石油气储罐区	nz
不燃性实体防护墙	nz
装卸区	nz
辅助生产区	nz
办公区	nz
可燃材料堆垛	nz
架空电力线	nz
最近水平距离	nz
地势较高	nz
地势较低	nz
丙类液体桶装堆场	nz
储罐防火堤	nz
半露天堆场	nz
浮顶储罐区	nz
液体卧式罐	nz
室外降压变电站	nz
立式储罐	nz
矩形储罐	nz
长边	nz
短边	nz
卧式储罐	nz
单罐容量	nz
固定冷却系统	nz
地上式固定顶储罐	nz
地上式储罐	nz
液下喷射泡沫灭火系统	nz
固定冷却水系统	nz
泡沫灭火设施	nz
沸溢性油品储罐	nz
非沸溢性油品储罐	nz
防火堤	nz
不燃性防火堤	nz
浮顶罐	nz
基脚线	nz
水平距离	nz
冷却系统	nz
含油污水排水管	nz
水封设施	nz
排水管	nz
雨水排水管	nz
封闭装置	nz
隔离装置	nz
桶装堆场	nz	
泵房	n	
鹤管	n	
零位罐	nz
储罐区	nz
湿式可燃气体储罐	nz
固定容积可燃气体储罐	nz
几何容积	nz
设计储存压力	nz
绝对压力	nz
干式可燃气体储罐	nz
水封井	nz
油泵房	nz
可燃气体储罐区	nz
球形储罐	nz
氧气储罐	nz
湿式氧气储罐	nz
制氧厂房	nz
气态氧	nz
液氧储罐	nz
医疗卫生机构	nz
医用液氧储罐气源站	nz
医用液氧储罐	nz
医用气体工程	nz	
沥青路面	n
液氢	n	
液氨	n
液氢储罐	nz
液氨储罐	nz
液化天然气气化站	nz
液化天然气储罐	nz
液化天然气储罐区	nz
站外建筑	nz	
居住区	n
村镇	n
液化石油气供应基地	nz
全压式储罐	nz
全压式储罐区	nz
半冷冻式储罐	nz
半冷冻式储罐区	nz
全冷冻式液化石油气储罐	nz
液化石油气气化站	nz
液化石油气混气站	nz
附属设备	nz
瓶装液化石油气供应站瓶库	nz
瓶装液化石油气供应站	nz
不燃性实体围墙	nz
不燃性非实体围墙	nz
露天可燃材料堆场	nz
半露天可燃材料堆场	nz
秸秆	n	
芦苇	n	
废纸	n	
木材堆场	nz
建筑高度	nz
单层民用建筑	nz
多层民用建筑	nz
高层民用建筑	nz
宿舍	nz	
公寓	n
非住宅类居住建筑	nz
居住建筑	nz
公共建筑	nz
燃烧性能	nz
不燃材料	nz
住宅建筑构件	nz
使用功能	nz
火灾扑救难度	nz
木结构建筑	nz
老年人照料设施	nz	
地下建筑	n
屋面防水层	nz
难燃材料	nz
可燃防水材料	nz
防水材料	nz
二级耐火等级建筑	nz
非承重外墙	nz
医疗建筑	nz
教学建筑	nz
托儿所	n	
幼儿园	n
儿童用房	nz
儿童游乐厅	nz
儿童活动场所	nz
门厅	n
预制钢筋混凝土构件	nz
总平面	nz
总平面布局	nz
消防车道	nz
消防水源	nz
单层建筑	nz
多层建筑	nz
消防车	n	
水源	n	
连廊	n	
天桥	n
连廊底部	nz
天桥底部	nz
既有建筑	nz	
终端变电站	nz
预装式变电站	nz
燃油锅炉房	nz
燃气锅炉房	nz
办公建筑	nz
燃气调压站	nz	
自动扶梯	n
敞开楼梯	nz	
中庭	n
防火分隔	nz
防火玻璃墙	nz
耐火隔热性	nz
耐火完整性	nz
非隔热性防火玻璃墙	nz	
回廊	n
自动喷水灭火系统	nz
火灾自动报警系统	nz
排烟设施	nz
商店营业厅	nz
展览厅	nz	
不燃装修材料	nz
难燃装修材料	nz
地下商店	nz
半地下商店	nz
下沉式广场	nz
室外开敞空间	nz
防火隔间	nz
餐饮	n
商业设施	nz
步行街	n
开启门窗	nz
端部	nz	
商铺	n
围护构件	nz
实体墙	n
乙级防火门	nz
闭式自动喷水灭火系统	nz
出挑宽度	nz
连接天桥	nz
开口面积	nz
地面面积	nz
最近室外安全地点	nz
步行距离	nz
顶棚下檐	nz
自然排烟设施	nz
常开式的排烟口	nz
排烟口	nz
自然排烟口	nz
有效面积	nz	
消火栓	n
消防软管卷盘	nz
消防水龙	nz
自动跟踪定位射流灭火系统	nz
疏散照明	nz
灯光疏散指示标志	nz
消防应急广播系统	nz
平面布置	n
附属库房	nz
生产车间	nz
库房	nz
作坊	n	
储藏间	n	
商店建筑	nz
展览建筑	nz
营业厅	nz
地下营业厅	nz
半地下营业厅	nz
地下展览厅	nz
半地下展览厅	nz
老年人公共活动用房	nz
康复与医疗用房设置	nz
医院	nz
疗养院	nz
住院部分	nz
病房楼	nz
护理单元	nz
常开防火门	nz
食堂	n
菜市场	n
剧场	n	
电影院	n	
礼堂	n
观众厅	n
会议厅	n	
多功能厅	n
歌舞厅	n	
录像厅	n	
夜总会	n
卡拉OK厅	nz	
餐厅	n	
游艺厅	n
电子游艺厅	nz
桑拿浴室	nz
洗浴部分	nz	
网吧	n
歌舞娱乐游艺场所	nz
袋形走道	nz
地坪	nz
室外出入口地坪	nz
厅	nz
室	nz
住宅部分	nz
非住宅部分	nz
地上车库	nz
地下车库	nz
燃油锅炉	nz
燃气锅炉	nz
油浸变压器	nz
高压电容器	nz
多油开关	nz
常压燃油锅炉	nz
负压燃油锅炉	nz
常压燃气锅炉	nz
负压燃气锅炉	nz
屋面	nz
相对密度	nz
空气密度	nz
锅炉间	n	
比值	n	
燃料	n	
储存量	n	
灭火设施	nz
爆炸泄压设施	nz
通风系统	nz
柴油发电机房	nz
机房	nz
储油间	nz
发电机	nz
发电机间	nz
柴油发电机容量	nz
建筑规模	nz
丙类液体燃料	nz
油罐	nz
中间罐	nz
锅炉发电机	nz
柴油发电机	nz
燃料供给管道	nz
自动切断阀	nz
手动切断阀	nz
切断阀	nz
油箱	nz
通气管	nz
阻火器	nz
呼吸阀	nz
防止油品流散的设施	nz
燃气供给管道	nz
可燃气体燃料	nz
自然气化方式供气	nz
液化石油气气瓶	nz
出气管道	nz
紧急事故自动切断阀	nz
可燃气体浓度报警装置	nz
规模	nz
建筑规模	nz
住宅单元	nz
电梯	n
半地下建筑	nz
地下建筑室	nz
半地下建筑室	nz
金属竖向梯	nz
歌舞娱乐放映游艺场所	nz
地下设备间	nz
半地下设备间	nz	
汽车库	n
电梯候梯厅	nz
挑出宽度	nz
防护挑檐	nz
挑檐	nz
疏散净宽度	nz
疏散总净宽度	nz
剪刀楼梯间	nz
梯段	n
顶层	nz
上人平屋面	nz
上人屋面	nz
敞开式外廊	nz
旅馆	nz
图书馆	n
会议中心	nz
室外避难场地	nz
客梯	nz
客电梯	nz
货梯	nz
货电梯	nz
多功能厅	nz
非消防电梯	nz
防烟措施	nz
体育馆	n
扩大的封闭楼梯间	nz
防烟楼梯间前室	nz
敞开楼梯间	nz
首层疏散门	nz
首层疏散外门	nz
门槛	nz
净宽度	nz
踏步	nz
宽敞地带	nz
横走道	nz
纵走道	nz
座椅	nz
座位	n
排数	n
排距	nz
内门	nz
外门	nz
楼梯	nz
座位数	n
首层外门	nz
固定座位	nz
建材商店	nz
家具	nz
灯饰	nz
展示建筑	nz
窗口	nz
金属栅栏	nz
楼地面	nz
灭火救援场地地面	nz
净面积	nz
避难人数	nz
设备层	nz
设备管道	nz
易燃液体	nz
可燃液体	nz
气体管道	nz
管道井	nz
避难区	nz
避难层区	nz
外窗	nz
消防电梯出口	nz
消防专线电话	n
应急广播	nz
指示标志	nz
可开启窗口	nz
机械防烟设施	nz
洁净手术部	nz
失能老年人	nz
简易防毒面具	nz
户门	n
共用前室	nz
合用前室	nz
安全疏散距离	nz
跃廊式住宅	nz	
栏杆	n	
基础	n
框架	nz
底面基层	nz
屋顶承重结构	nz
防火墙横截面中心线	nz
天窗端面	nz
可燃性墙体	nz
防止火势蔓延的措施	nz
排气道	nz
防火封堵材料	nz	
空隙	n	
屋架	n	
舞台	n
闷顶	n	
灯光操作室	nz	
可燃物储藏室	nz
电影放映室	nz
卷片室	nz
观察孔	nz
放映孔	nz
手术室	n
手术部	nz
产房	n
重症监护室	nz
贵重精密医疗装备用房	nz
实验室	n	
胶片室	nz
剧场后台	nz
后台	n
辅助用房	nz
套内	nz	
厨房	n
公共厨房	nz
机动车库	nz
地面基层	nz
分户墙	nz
隔板	n
防火挑檐	nz	
幕墙	n
建筑幕墙	nz
消防控制室	nz
灭火设备室	nz
消防水泵房	nz
通风空气调节机房	nz
变配电室	nz
通风机房	nz
空气调节机房	nz
低温环境生产场所	nz
可燃材料	nz
绝热层	n
不燃绝热材料	nz
冷库阁楼层	nz
可燃绝热层	nz
加工车间	nz
氨压缩机	nz
电梯井	nz
竖井	nz	
电缆	n	
电线	n
电梯门	n
安全逃生门	nz
通气孔洞	nz
电缆井	nz
排烟道	nz
垃圾道	nz
竖向井道	nz
检查门	nz
丙级防火门	nz	
孔隙	n
排气口	n
垃圾斗	n
电梯层门	nz
耐火试验	nz
热通量测定法	nz
点致发光广告牌	nz
广告牌	nz
户外广告牌	nz
外部灭火救援行动	nz
冷摊瓦	nz
非金属烟囱	nz
金属烟囱	nz
防火隔断	nz
老虎窗	nz
变形缝	nz
填充材料	nz
构造基层	nz
走廊	n	
套管	n
防变形措施	nz
防烟系统	nz
排烟系统	nz
供暖系统	nz
空气调节系统	nz
风管	nz
防火阀	nz
排烟防火阀	nz
风管外壁	nz
开口	nz
天然采光	nz
自然通风	nz
烧水间	nz
可燃材料储藏室	nz
凸出物	nz
障碍物	nz
液体管道	nz
可燃气体管道	nz
可燃气体计量表	nz
金属管	nz
阀门	nz
机械加压送风系统	nz
双向弹簧门	nz
使用面积	nz
消防电梯	nz
送风口	nz
套内的自用楼梯	nz
室内地面	nz
共用楼梯间	nz
标志	nz
栏杆扶手	nz
倾斜角度	nz
金属梯	nz
工作平台	nz
螺旋楼梯	nz
扇形踏步	nz
扶手	nz
公共疏散楼梯	nz
水平净距	nz
室外消防梯	nz
常开甲级防火门	nz
平开门	nz
推拉门	nz
卷帘门	nz
吊门	nz
转门	nz
折叠门	nz
楼梯平台	nz
有效宽度	nz
门禁系统	n
宿舍建筑	nz
防风雨篷	nz	
雨篷	n	
百叶	n
有效排烟面积	nz
百叶通风口面积	nz
内部装修材料	nz
消防应急照明	nz
信号反馈的功能	nz
提示标识	nz
管井检修门	nz
双扇防火门	nz
防烟功能	nz
防火窗	nz
靠自重自动关闭功能	nz
墙	nz
栈桥	nz
封闭天桥	nz
封闭管沟	nz
封闭管廊	nz
外保温系统	nz
A级保温材料	nz
B1级保温材料	nz
B2级保温材料	nz
B3级保温材料	nz
保温系统	nz
基层墙体	nz
内保温系统	nz
火	nz
燃油	nz
燃气	nz
低烟保温材料	nz
低毒保温材料	nz
无空腔复合保温结构体	nz
装饰层	nz
水平防火隔离带	nz
防火隔离带	nz
电气线路	nz
插座	nz
电器配件	nz
街区	nz
道路中心线	nz
环形消防车道	nz
会堂	nz
多层公共建筑	nz
山坡地	nz
河道边	nz
建筑立面	nz
消防车登高操作面	nz
封闭内院	nz
内院	nz
天井	nz
人行通道	nz
可燃材料露天堆场区	nz
天然水源	nz
消防水池	nz
车道	nz
树木	n
架空管线	nz
尽头式消防车道	nz
回车道	nz
回车场	nz
重型消防车	nz
救援操作场地	nz
暗沟	nz
厂区道路	nz
备用车道	nz
火车	nz
消防车登高操作场地	nz
场地	nz
车库出入口	nz
高层塔架	nz
局部建筑高度	nz
仓库连廊	nz
冷库穿堂	nz
正压送风口	nz
消防电梯井	nz
井底	s
排水设施	nz
排水井	nz
排水泵	n	
排水量	n
挡水设施	nz
载重量	n
动力与控制电缆	nz
控制面板	nz
防水措施	nz
供消防队员专用的操作按钮	nz
电梯轿厢	nz
消防对讲电话	nz
标准层	nz
直升机停机坪	nz
供直升机救助的设施	nz
屋顶平台	nz
设备机房	nz
电梯机房	nz
水箱间	nz
共用天线	nz
突出物	nz
停机坪	nz
航空障碍灯	nz
应急照明	nz
消防给水设施	nz
消防设施	nz
城镇	nz		
商业区	n	
开发区	n	
工业区	n
市政消火栓系统	nz
水喷雾灭火系统	nz
泡沫灭火系统	nz
固定消防炮灭火系统	nz
室内消火栓给水系统	nz
消防水泵接合器	nz
移动水枪	nz
固定水冷却设施	nz
地上储罐	nz
移动式水枪	nz
消防设备	n
远程监控系统	nz
防水淹的技术措施	nz
防排烟风机	nz
防火分隔措施	nz
墙体装饰材料	nz
水泵接合器	nz
室外消火栓	nz
室外消防设施	nz
干式消防竖管	nz
室内消火栓	nz
灭火器	n	
玻璃幕墙	n
竖管	n
消火栓箱	n
车站	n	
码头	n	
机场	n
候车建筑	nz
候船建筑	nz	
候机建筑	nz
旅馆建筑	nz
图书馆建筑	nz
特等剧场	nz
甲等剧场	nz
轻便消防水龙	nz
粮食仓库	nz
独立建筑	nz
能引起燃烧爆炸的物品	nz	nz
生产给水管道	nz
生活给水管道	nz
室外消防用水	nz
储水池	nz
国家级文物保护单位	nz
砖木结构古建筑	nz
木结构古建筑	nz
开包车间	nz	
棉纺厂	n
麻纺厂	nz	
梳麻车间	nz	
火柴厂	n		
制鞋厂房	n	
制衣厂房	n	
玩具厂房	n	
电子厂房	nz
木器厂房	nz
泡沫塑料厂	nz
预发部位	nz	
成型部位	n	
切片部位	n	
压花部位	n
地下丙类厂房	nz
半地下丙类厂房	nz
火柴仓库	nz
邮政建筑	nz
空邮袋库	nz
高架冷库	nz
非高架冷库	nz
可燃物品地下仓库	nz
游泳池	n	
溜冰场	n
自动扶梯底部	nz
公共活动用房	nz
客房	n	
体育场	n
门诊楼	nz
送回风道	nz
送回风管	nz
集中空气调节系统	nz
大型幼儿园	nz
中型幼儿园	nz
高大空间场所	nz
水幕系统	nz
防火幕	nz
侧台	nz
雨淋自动喷水灭火系统	nz
氯酸钾压碾厂房	nz
硝化棉厂房	nz
喷漆棉厂房	nz
火胶棉厂房	nz
赛璐珞胶片厂房	nz
硝化纤维厂房	nz
乒乓球厂	nz
灌瓶间	nz
实瓶库	nz	
演播室	n
电影摄影棚	nz
厂矿企业油浸变压器	nz
电厂油浸变压器	nz
独立变电站油浸变压器	nz
飞机发动机试验台	nz
多油开关室	nz
试车部位	nz
细水雾灭火系统	nz
广播电视发射塔	nz
微波机房	nz	
分米波机房	nz
米波机房	nz
不间断电源室	nz
国际电信局	nz
长途程控交换机房	nz
控制室	nz
信令转接点室	nz
调度指挥中心	nz
通信机房	n
A级电子信息系统机房	nz
B级电子信息系统机房	nz
主机房	nz
工作间	nz
广播电视中心	nz
音像制品库房	nz
特藏库	nz
档案馆	n
珍藏库	nz
非纸质博物馆	nz
大型博物馆	nz
中型博物馆	nz
珍品库房	nz
一级纸绢文物	nz
陈列室	nz
石油天然气工程
餐馆	n
烹饪操作间	nz
排油烟罩	nz
燃气管道	nz
燃油管道	nz
食品工业加工场所	nz
明火作业	nz
高温食用油	nz
食品加工部位	nz
卷烟仓库	nz
财贸金融建筑	nz
客运建筑	nz
货运建筑	nz
广播电视建筑	nz
电信建筑	nz
指挥调度建筑	nz
记录介质库	nz
仪器设备室	nz
贵重物品库房	nz
警报装置	nz
火灾探测器	nz
技术夹层	nz
消防广播	nz
无窗房间	nz
送风设备	nz
排风设备	nz
水平排风管	nz
通风管道	nz
散热器	nz
输煤廊	nz
电热散热器供暖	nz
热风供暖	nz
供暖管道	nz
排风管道	nz
水平送风管	nz
竖向送风管	nz
送风系统	nz
通风设备	nz
排风系统	nz
送风机	nz
通风机	nz
风干管	nz
防止回流设施	nz
除尘器	nz
湿式除尘器	nz
干式除尘器	nz
过滤器	nz
集尘斗	nz
泄压装置	nz
接地装置	n
排风管	nz
水平管段	nz
水平风管	nz
竖向总管	nz
浴室	n	
卫生间	n
竖向排风管	nz
排油烟管道	nz
支管	nz
检修口	nz
柔性接头	nz
展览馆	n
绝热材料	nz
加湿器	n
加湿材料	nz
消声材料	nz
粘结剂	nz
电加热器	nz
开关	nz
风机	nz
事故排风机	nz
机械通风设施	nz
导除静电的接地装置	nz
室外消防用水量	nz
消防用电	nz
供电电源	nz
备用电源	nz
连续供电时间	nz
消防用电设备	nz
供电回路	nz
备用消防电源	nz
建筑火灾延续时间	nz
消防配电干线	nz
消防配电支线	nz
消防水泵室	nz
防烟风机房	nz
排烟风机房	nz
配电线路	nz	
配电箱	nz
消防配电线路	nz
金属导管	nz
封闭式金属槽盒	nz
阻燃电缆	nz
耐火电缆	nz
不燃性电缆	nz
不燃性结构	nz
自备发电设备	nz
自动启动装置	nz
手动启动装置	nz
照明灯具	nz
卤钨灯	n
额定功率	n
白炽灯泡	nz
吸顶灯	n
槽灯	nz
嵌入式灯	nz	
瓷管	n
矿棉	n
高压钠灯	nz
金属卤化物灯	nz	
荧光高压汞灯	nz
电感镇流器	nz	
低温照明灯具	nz
灯具	n
发热部件	nz
高温照明灯具	nz
电气火灾监控系统	nz
疏散照明灯具	nz
备用照明灯具	nz
走道转角区	nz
车站建筑	nz
码头建筑	nz
民用机场航站楼	nz
候车厅	nz
候船厅	nz
航站楼	nz
公共区	nz
木骨架组合墙体	nz
配电间	nz
木结构住宅建筑	nz
民用木结构建筑	nz
木结构厂房	nz
密闭空间	nz
轻型木结构建筑	nz
楼梯梁	nz
钢结构	nz
钢筋混凝土结构	nz
砌体结构	nz
室内消防给水	nz
嵌缝材料	nz
双孔隧道	nz
水底隧道	nz
非水底隧道	nz
单孔隧道	nz
地下设备用房	nz
运营管理中心	nz
独立避难所	nz
消防用水量	nz
寒冷地区	nz
防冻措施	nz
管网	n
消火栓栓口	nz
排烟方式	nz
消声器	nz
无线通信	nz
通信联络	n
高压电缆	nz


